[
  {
    "type": "mapgen",
    "method": "json",
    "om_terrain": [ "cabin_strange_b" ],
    "weight": 450,
    "object": {
      "rows": [
        "########################",
        "##.hh..#c..cc###########",
        "##hee..#c....#...#######",
        "##hee..+.....G.b8#######",
        "##.hh..#.....#...#######",
        "##.....#....c###########",
        "###...####x###|---|---|#",
        "####x#####.###|c.h|<..|#",
        "##.rrr.##...##|..d|-x-|#",
        "#.rrrrr.#.I.##|-+-|..h##",
        "#.pprpp.#...##c......c##",
        "#.rrrrr.#.I.##ccI..Icc##",
        "#.pprpp.#...##cc.....{##",
        "#.rrrrr.#.I.##ccI..I.{##",
        "#.pprpp.#...##ee..ch.{##",
        "#.rrrrr.#.I.##eeIccI..##",
        "#..rrr..#............h##",
        "#.b.a.b.#.I..I..I..I.c##",
        "##.....##.dh.cc...BBcc##",
        "###+#+##################",
        "##....]#################",
        "##dd..]#################",
        "##dh..]#################",
        "########################"
      ],
      "palettes": [ "arcana_palette" ],
      "terrain": { "p": "t_carpet_red", "G": "t_door_bar_locked" },
      "mapping": {
        ".": { "items": { "item": "subway", "chance": 5 } },
        "a": { "furniture": "f_slab", "item": { "item": "etched_skull" } },
        "c": {
          "items": [ { "item": "dresser", "chance": 15 }, { "item": "creepy", "chance": 5 } ],
          "b": { "furniture": "f_brazier", "items": { "item": "cult_sacrifice" } }
        },
        "]": { "furniture": "f_bookcase", "items": { "item": "mansion_bookcase" } },
        "{": { "furniture": "f_rack", "items": { "item": "cannedfood", "chance": 30 } }
      },
      "place_loot": [ { "item": "book_magicfordummies", "x": 17, "y": 8 }, { "item": "note_starry_missive", "x": [ 2, 3 ], "y": 21 } ],
      "place_monster": [
        { "monster": "mon_dementia", "x": 4, "y": 12, "repeat": [ 3, 6 ] },
        { "monster": "mon_dementia", "x": 10, "y": 3, "repeat": [ 1, 4 ] },
        { "monster": "mon_dementia", "x": 12, "y": 7 },
        { "monster": "mon_homunculus", "x": 16, "y": 4 },
        { "monster": "mon_flesh_angel", "x": 3, "y": 22 }
      ]
    }
  },
  {
    "type": "mapgen",
    "method": "json",
    "om_terrain": [ "necropolis_b_54" ],
    "weight": 375,
    "object": {
      "fill_ter": "t_floor",
      "rows": [
        "########################",
        "########################",
        "########################",
        "#|--------|#############",
        "#|???cc..]|#.###########",
        "#|...Ic..]x...##########",
        "#|.......]|#..B#########",
        "#|D....AAA|#..D#########",
        "#|D......<|#...C########",
        "#|--------|#...C########",
        "#|hee....<|#...C########",
        "#|hee..AAA|#..d#########",
        "#|.......]|#..h#########",
        "#|...I...]x...##########",
        "#|fccchh.]|#.###########",
        "#|--------|#############",
        "########################",
        "########################",
        "########################",
        "########################",
        "########################",
        "########################",
        "########################",
        "########################"
      ],
      "palettes": [ "arcana_palette" ],
      "terrain": {
        "?": "t_rock_floor",
        "A": "t_railing_h"
      },
      "furniture": {
        "?": "f_sofa"
      },
      "mapping": {
        ".": { "item": { "item": "rock", "chance": 5 } },
        "]": { "furniture": "f_bookcase", "items": { "item": "mansion_bookcase", "chance": 50 } },
        "d": {
          "item": [ { "item": "book_magicfordummies" }, { "item": "note_soa_mission", "chance": 40, "repeat": 3 } ]
        },
        "C": {
          "items": [ { "item": "tools_survival", "chance": 50 }, { "item": "cannedfood", "chance": 40, "repeat": 3 } ]
        }
      },
      "place_items": [ { "item": "alcohol", "x": [ 2, 2 ], "y": [ 14, 14 ], "chance": 90 } ],
      "place_monsters": [ { "monster": "GROUP_NECROPOLIS_SEWERS", "x": [ 1, 22 ], "y": [ 1, 22 ], "density": 0.1 } ]
    }
  }
]
