[
  {
    "type": "mapgen",
    "method": "json",
    "om_terrain": [ "shrine_anomaly" ],
    "weight": 300,
    "object": {
      "fill_ter": "t_floor",
      "rows": [
        "                        ",
        "                        ",
        "  O                  O  ",
        "        mmmmmmmm        ",
        "       mmppppppmm       ",
        "      mmppppppppmm      ",
        "     mmppp,,_,pppmm     ",
        "    mmppp,,,,,,pppmm    ",
        "   mmpppO......Opppmm   ",
        "   mppp,........,pppm   ",
        "   mpp,,........,,ppm   ",
        "   mpp_,........,,ppm   ",
        "   mpp,,........,_ppm   ",
        "   mpp,,........,,ppm   ",
        "   mppp,........,pppm   ",
        "   mmpppO......Opppmm   ",
        "    mmppp,,,,,,pppmm    ",
        "     mmppp,_,,pppmm     ",
        "      mmppppppppmm      ",
        "       mmppppppmm       ",
        "        mmmmmmmm        ",
        "  O                  O  ",
        "                        ",
        "                        "
      ],
      "terrain": {
        " ": [ "t_dirt", "t_dirt", "t_dirt", "t_grass", "t_shrub" ],
        ",": "t_dirt",
        ".": "t_pavement",
        "O": "t_column",
        "p": "t_pit_shallow",
        "m": "t_rock_floor",
        "_": "t_dirt"
      },
      "furniture": {
        "_": "f_brazier"
      },
      "set": [
        { "point": "trap", "id": "tr_glow", "x": [ 9, 14 ], "y": [ 9, 14 ], "repeat": [ 2, 3 ] },
        { "point": "trap", "id": "tr_hum", "x": [ 9, 14 ], "y": [ 9, 14 ], "repeat": [ 2, 3 ] },
        { "point": "trap", "id": "tr_drain", "x": [ 9, 14 ], "y": [ 9, 14 ], "repeat": [ 2, 3 ] }
      ],
      "place_loot": [
        { "group": "cult_sacrifice", "x": 12, "y": 6 },
        { "group": "cult_sacrifice", "x": 17, "y": 12 },
        { "group": "cult_sacrifice", "x": 11, "y": 17 },
        { "group": "cult_sacrifice", "x": 6, "y": 11 },
        { "item": "meteoric_talisman", "x": [ 11, 12 ], "y": [ 11, 12 ] }
      ],
      "place_monsters": [
        { "monster": "GROUP_IMPACT_FLYING", "x": [ 6, 17 ], "y": [ 6, 17 ], "density": 0.1 }
      ]
    }
  },
  {
    "type": "mapgen",
    "method": "json",
    "om_terrain": [ "shrine_anomaly" ],
    "weight": 300,
    "object": {
      "fill_ter": "t_floor",
      "rows": [
        "                        ",
        "  #TTTTTT##,,##TTTTTT#  ",
        " ##T,,,,,,,,,,,,,,,,T## ",
        " TT,,TTTTT#++#TTTTT,,TT ",
        " T,,##............##,,T ",
        " T,##..O........O..##,T ",
        " T,TB..............BT,T ",
        " T,TB..O........O..BT,T ",
        " T,TB..............BT,T ",
        " #,TB..O........O..BT,# ",
        " #,#B..............B#,# ",
        " ,,########++########,, ",
        " ,,#................#,, ",
        " #,#.b....C..C....b.#,# ",
        " #,#.b..C......C..b.#,# ",
        " T,#.b............b.#,T ",
        " T,#.b............b.#,T ",
        " T,#....C......C....#,T ",
        " T,##.....C..C.....##,T ",
        " T,,##.....RR.....##,,T ",
        " TT,,##############,,TT ",
        " ##T,,,,,,,,,,,,,,,,T## ",
        "  #TTTTTT##,,##TTTTTT#  ",
        "                        "
      ],
      "terrain": {
        " ": [ "t_grass", "t_grass", "t_grass", "t_shrub", "t_shrub", "t_dirt" ],
        "T": [ "t_rock_smooth", "t_rock_smooth", "t_dirt", "t_lava" ],
        "#": "t_rock_smooth",
        ",": "t_pavement",
        "O": "t_column",
        ".": "t_rock_floor",
        "B": "t_rock_floor",
        "C": "t_rock_floor",
        "R": "t_rock_floor",
        "+": "t_door_locked"
      },
      "furniture": {
        "B": "f_bookcase",
        "b": "f_bench",
        "R": "f_rack",
        "C": "f_coffin_o"
      },
      "place_loot": [
        { "group": "summoner_casualties", "x": 10, "y": 13, "chance": 80 },
        { "group": "summoner_casualties", "x": 13, "y": 13, "chance": 80 },
        { "group": "summoner_casualties", "x": 8, "y": 14, "chance": 80 },
        { "group": "summoner_casualties", "x": 15, "y": 14, "chance": 80 },
        { "group": "summoner_casualties", "x": 8, "y": 17, "chance": 80 },
        { "group": "summoner_casualties", "x": 15, "y": 17, "chance": 80 },
        { "group": "summoner_casualties", "x": 10, "y": 18, "chance": 80 },
        { "group": "summoner_casualties", "x": 13, "y": 18, "chance": 80 },
        { "group": "unaligned_arcanist_books", "x": 4, "y": [ 6, 10 ], "chance": 40, "repeat": [ 2, 6 ] },
        { "group": "unaligned_arcanist_books", "x": 19, "y": [ 6, 10 ], "chance": 40, "repeat": [ 2, 6 ] },
        { "item": "essence_blood", "x": [ 11, 12 ], "y": 19, "chance": 50, "repeat": [ 5, 10 ] },
        { "item": "jade_wreath", "x": [ 11, 12 ], "y": 19 }
      ],
      "place_monster": [
        { "monster": "mon_dementia", "x": [ 8, 15 ], "y": [ 5, 10 ], "repeat": [ 3, 6 ] },
        { "monster": "mon_blood_sacrifice", "x": 10, "y": 10 },
        { "monster": "mon_blood_sacrifice", "x": 13, "y": 10 },
        { "monster": "mon_shoggoth", "x": 11, "y": 15, "chance": 50 }
      ]
    }
  },
  {
    "type": "mapgen",
    "method": "json",
    "om_terrain": [ "shrine_anomaly" ],
    "weight": 300,
    "object": {
      "fill_ter": "t_floor",
      "rows": [
        "                        ",
        "                        ",
        "                        ",
        "   wwwwwwss  sswwwwww   ",
        "   w                w   ",
        "   w ######++###### w   ",
        "   w #bbb..__..rrr# w   ",
        "   w #.....__.....# w   ",
        "   w #..O.O__O.O..# w   ",
        "   s #.....__.....# s   ",
        "   s #..O.____.O..# s   ",
        "     +_____tt_____+     ",
        "     +_____tt_____+     ",
        "   s #..O.____.O..# s   ",
        "   s #.....__.....# s   ",
        "   w #..O.O__O.O..# w   ",
        "   w #.....__.....# w   ",
        "   w #rrr..__..bbb# w   ",
        "   w ######++###### w   ",
        "   w                w   ",
        "   wwwwwwss  sswwwwww   ",
        "                        ",
        "                        ",
        "                        "
      ],
      "terrain": {
        " ": [ "t_dirt", "t_dirt", "t_grass", "t_shrub", "t_water_sh", "t_swater_sh" ],
        "#": "t_wall",
        "s": "t_water_sh",
        "w": "t_water_dp",
        ".": "t_rock_floor",
        "+": "t_door_locked",
        "O": "t_column",
        "b": "t_rock_floor",
        "r": "t_rock_floor",
        "t": "t_carpet_green",
        "_": "t_carpet_green"
      },
      "furniture": {
        "b": "f_bookcase",
        "r": "f_rack",
        "t": "f_table"
      },
      "set": [
        { "point": "trap", "id": "tr_snake", "x": [ 6, 17 ], "y": [ 6, 17 ], "repeat": [ 5, 10 ] }
      ],
      "place_loot": [
        { "group": "unaligned_arcanist_books", "x": [ 6, 8 ], "y": 6, "chance": 40, "repeat": [ 2, 4 ] },
        { "group": "magic_items", "x": [ 15, 17 ], "y": 6, "chance": 40, "repeat": [ 2, 4 ] },
        { "group": "magic_consumables", "x": [ 6, 8 ], "y": 17, "chance": 40, "repeat": [ 2, 4 ] },
        { "group": "unaligned_arcanist_books", "x": [ 15, 17 ], "y": 17, "chance": 40, "repeat": [ 2, 4 ] },
        { "item": "moonstone_fang", "x": [ 11, 12 ], "y": [ 11, 12 ] }
      ],
      "place_monster": [
        { "monster": "mon_rattlesnake", "x": [ 0, 23 ], "y": [ 0, 4 ], "repeat": [ 2, 4 ] },
        { "monster": "mon_rattlesnake_giant", "x": [ 0, 23 ], "y": [ 19, 23 ], "repeat": [ 2, 4 ] },
        { "monster": "mon_sewer_snake", "x": [ 0, 4 ], "y": [ 0, 23 ], "repeat": [ 3, 6 ] },
        { "monster": "mon_sewer_snake", "x": [ 19, 23 ], "y": [ 0, 23 ], "repeat": [ 3, 6 ] },
        { "monster": "mon_twisted_body", "x": 11, "y": 15, "chance": 50 }
      ]
    }
  }
]
