[
  {
    "id": "sanguine_cult_books",
    "type": "item_group",
    "items": [
      [ "plays_book", 4 ],
      [ "poetry_book", 4 ],
      [ "philosophy_book", 2 ],
      [ "novel_drama", 1 ],
      [ "essay_book", 2 ],
      [ "cookbook_human", 1 ],
      [ "textbook_speech", 1 ],
      [ "book_bloodmagic", 6 ],
      [ "book_summoning", 1 ],
      [ "book_potioncraft", 2 ]
    ]
  },
  {
    "id": "sanguine_cult_spells",
    "type": "item_group",
    "items": [
      [ "scroll_spell_confusion", 1 ],
      [ "scroll_spell_agile", 1 ],
      [ "scroll_spell_elecresist", 1 ],
      [ "scroll_spell_clarity", 1 ],
      [ "scroll_spell_acidspray", 1 ]
    ]
  },
  {
    "id": "sanguine_cult_gear",
    "type": "item_group",
    "items": [
      [ "blood_athame", 5 ],
      [ "bloodaxe", 3 ],
      [ "bloodscourge", 2 ],
      [ "armor_wyrm", 3 ],
      [ "revenant_crown", 2 ],
      [ "portal", 1 ]
    ]
  },
  {
    "id": "sanguine_cult_consumables",
    "type": "item_group",
    "items": [
      { "item": "essence_blood", "prob": 10, "count": [ 1, 3 ] },
      [ "numbness_potion", 4 ],
      [ "strength_potion", 1 ],
      [ "speed_potion", 2 ],
      [ "summon_dark_wyrm", 1 ],
      [ "summon_mi_go", 1 ],
      [ "summon_flying_polyp", 1 ],
      [ "summon_yugg", 1 ]
    ]
  },
  {
    "id": "sanguine_cult_casualties",
    "type": "item_group",
    "subtype": "collection",
    "entries": [
      { "group": "underwear", "damage": [ 1, 4 ] },
      { "group": "shirts", "damage": [ 1, 4 ] },
      { "group": "pants", "damage": [ 1, 4 ] },
      { "group": "shoes", "damage": [ 1, 4 ] },
      { "group": "sanguine_cult_gear", "prob": 25 },
      { "item": "corpse" }
    ]
  },
  {
    "id": "sanguine_ritual",
    "type": "item_group",
    "subtype": "collection",
    "entries": [ { "item": "silver_glyph" }, { "item": "essence_blood" }, { "item": "cleric_ring" } ]
  },
  {
    "type": "mapgen",
    "method": "json",
    "om_terrain": [ "island_temple_1" ],
    "weight": 250,
    "object": {
      "fill_ter": "t_dirt",
      "rows": [
        ",,,,,,,,,,,,,,,,,,,````,",
        ",,,````````````````````=",
        ",,``````````````````~~~=",
        ",`````~~~~~~~~~~~~~~~~~=",
        ",````~~~~~~~~~~~~~~~~~~=",
        ",```~~~~~~~~~~~~~~~~~~~=",
        ",``~~~~~~~~~~~~~~~~~~~~=",
        ",``~~~~~~~~~~~~~~~~~~~~=",
        ",``~~~~~~~~~~~~~~~~~~~~=",
        ",``~~~~~~~~~~~~~~~~~~~~=",
        ",``~~~~~~~~~~~~~~~~~~~~=",
        ",``~~~~~~~~~~~~~~~~~~~~=",
        ",``~~~~~~~~~~~~~~~~````=",
        ",``~~~~~~~~~~~~~~~~````,",
        ",``~~~~~~~~~~~~~~~```,,,",
        ",``~~~~~~~~~~~~~~~```,##",
        ",``~~~~~~~~~~~~~````,,+.",
        ",``~~~~~~~~~~~~~````,##.",
        ",``~~~~~~~~~~~````,,,#d.",
        ",``~~~~~~~~~``````,###c.",
        "```~~~~~~~~~````,,,#....",
        "``~~~~~~~~~~``,,,###.##+",
        "``~~~~~~~~~~``,#+#dc.#..",
        ",============,,#.....+.>"
      ],
      "terrain": {
        "#": "t_wall",
        "+": "t_door_c",
        ",": "t_dirt",
        ".": "t_floor",
        "=": "t_bridge",
        ">": "t_stairs_down",
        "`": "t_water_sh",
        "c": "t_floor",
        "d": "t_floor",
        "~": "t_water_dp"
      },
      "furniture": { "c": "f_chair", "d": "f_desk" },
      "place_loot": [
        { "group": "sanguine_cult_casualties", "x": 22, "y": 2, "chance": 30 },
        { "group": "sanguine_cult_casualties", "x": 19, "y": 22, "chance": 30 }
      ],
      "place_monsters": [ { "monster": "GROUP_IMPACT", "x": [ 0, 23 ], "y": [ 0, 23 ], "density": 0.1 } ]
    }
  },
  {
    "type": "mapgen",
    "method": "json",
    "om_terrain": [ "island_temple_2" ],
    "weight": 250,
    "object": {
      "fill_ter": "t_dirt",
      "rows": [
        ",````,,,,,,,,,,,,,,,,,,,",
        "=````````````````````,,,",
        "=~~~``````````````````,,",
        "=~~~~~~~~~~~~~~~~~`````,",
        "=~~~~~~~~~~~~~~~~~~````,",
        "=~~~~~~~~~~~~~~~~~~~```,",
        "=~~~~~~~~~~~~~~~~~~~~``,",
        "=~~~~~~~~~~~~~~~~~~~~``,",
        "=~~~~~~~~~~~~~~~~~~~~``,",
        "=~~~~~~~~~~~~~~~~~~~~``,",
        "=~~~~~~~~~~~~~~~~~~~~``,",
        "=~~~~~~~~~~~~~~~~~~~~``,",
        "=````~~~~~~~~~~~~~~~~``,",
        ",````~~~~~~~~~~~~~~~~``,",
        ",,,```~~~~~~~~~~~~~~~``,",
        "##,```~~~~~~~~~~~~~~~``,",
        ".+,,````~~~~~~~~~~~~~``,",
        ".##,````~~~~~~~~~~~~~``,",
        ".d#,,,````~~~~~~~~~~~``,",
        ".c###,``````~~~~~~~~~``,",
        "....#,,,````~~~~~~~~~```",
        "+##.###,,,``~~~~~~~~~~``",
        "..#.cd#+#,``~~~~~~~~~~``",
        ">.+.....#,,============,"
      ],
      "terrain": {
        "#": "t_wall",
        "+": "t_door_c",
        ",": "t_dirt",
        ".": "t_floor",
        "=": "t_bridge",
        ">": "t_stairs_down",
        "`": "t_water_sh",
        "c": "t_floor",
        "d": "t_floor",
        "~": "t_water_dp"
      },
      "furniture": { "c": "f_chair", "d": "f_desk" },
      "place_loot": [
        { "group": "sanguine_cult_casualties", "x": 1, "y": 19, "chance": 30 },
        { "group": "sanguine_cult_casualties", "x": 4, "y": 22, "chance": 30 }
      ],
      "place_monsters": [ { "monster": "GROUP_IMPACT", "x": [ 0, 23 ], "y": [ 0, 23 ], "density": 0.1 } ]
    }
  },
  {
    "type": "mapgen",
    "method": "json",
    "om_terrain": [ "island_temple_3" ],
    "weight": 250,
    "object": {
      "fill_ter": "t_dirt",
      "rows": [
        ",============,,#.....+.>",
        "``~~~~~~~~~~``,#+#dc.#..",
        "``~~~~~~~~~~``,,,###.##+",
        "``~~~~~~~~~~````,,,#....",
        "```~~~~~~~~~``````,###c.",
        ",``~~~~~~~~~~~````,,,#d.",
        ",``~~~~~~~~~~~~~````,##.",
        ",``~~~~~~~~~~~~~````,,+.",
        ",``~~~~~~~~~~~~~~~```,##",
        ",``~~~~~~~~~~~~~~~```,,,",
        ",``~~~~~~~~~~~~~~~~````,",
        ",``~~~~~~~~~~~~~~~~````=",
        ",``~~~~~~~~~~~~~~~~~~~~=",
        ",``~~~~~~~~~~~~~~~~~~~~=",
        ",``~~~~~~~~~~~~~~~~~~~~=",
        ",``~~~~~~~~~~~~~~~~~~~~=",
        ",``~~~~~~~~~~~~~~~~~~~~=",
        ",``~~~~~~~~~~~~~~~~~~~~=",
        ",```~~~~~~~~~~~~~~~~~~~=",
        ",````~~~~~~~~~~~~~~~~~~=",
        ",`````~~~~~~~~~~~~~~~~~=",
        ",,``````````````````~~~=",
        ",,,````````````````````=",
        ",,,,,,,,,,,,,,,,,,,````,"
      ],
      "terrain": {
        "#": "t_wall",
        "+": "t_door_c",
        ",": "t_dirt",
        ".": "t_floor",
        "=": "t_bridge",
        ">": "t_stairs_down",
        "`": "t_water_sh",
        "c": "t_floor",
        "d": "t_floor",
        "~": "t_water_dp"
      },
      "furniture": { "c": "f_chair", "d": "f_desk" },
      "place_loot": [
        { "group": "sanguine_cult_casualties", "x": 19, "y": 1, "chance": 30 },
        { "group": "sanguine_cult_casualties", "x": 4, "y": 22, "chance": 30 }
      ],
      "place_monsters": [ { "monster": "GROUP_IMPACT", "x": [ 0, 23 ], "y": [ 0, 23 ], "density": 0.1 } ]
    }
  },
  {
    "type": "mapgen",
    "method": "json",
    "om_terrain": [ "island_temple_4" ],
    "weight": 250,
    "object": {
      "fill_ter": "t_dirt",
      "rows": [
        ">.+.....#,,============,",
        "..#.cd#+#,``~~~~~~~~~~``",
        "+##.###,,,``~~~~~~~~~~``",
        "....#,,,````~~~~~~~~~~``",
        ".c###,``````~~~~~~~~~```",
        ".d#,,,````~~~~~~~~~~~``,",
        ".##,````~~~~~~~~~~~~~``,",
        ".+,,````~~~~~~~~~~~~~``,",
        "##,```~~~~~~~~~~~~~~~``,",
        ",,,```~~~~~~~~~~~~~~~``,",
        ",````~~~~~~~~~~~~~~~~``,",
        "=````~~~~~~~~~~~~~~~~``,",
        "=~~~~~~~~~~~~~~~~~~~~``,",
        "=~~~~~~~~~~~~~~~~~~~~``,",
        "=~~~~~~~~~~~~~~~~~~~~``,",
        "=~~~~~~~~~~~~~~~~~~~~``,",
        "=~~~~~~~~~~~~~~~~~~~~``,",
        "=~~~~~~~~~~~~~~~~~~~~``,",
        "=~~~~~~~~~~~~~~~~~~~```,",
        "=~~~~~~~~~~~~~~~~~~````,",
        "=~~~~~~~~~~~~~~~~~`````,",
        "=~~~```````````````````,",
        "=`````````````````````,,",
        ",````,,,,,,,,,,,,,,,,,,,"
      ],
      "terrain": {
        "#": "t_wall",
        "+": "t_door_c",
        ",": "t_dirt",
        ".": "t_floor",
        "=": "t_bridge",
        ">": "t_stairs_down",
        "`": "t_water_sh",
        "c": "t_floor",
        "d": "t_floor",
        "~": "t_water_dp"
      },
      "furniture": { "c": "f_chair", "d": "f_desk" },
      "place_loot": [
        { "group": "sanguine_cult_casualties", "x": 4, "y": 1, "chance": 30 },
        { "group": "sanguine_cult_casualties", "x": 1, "y": 4, "chance": 30 }
      ],
      "place_monsters": [ { "monster": "GROUP_IMPACT", "x": [ 0, 23 ], "y": [ 0, 23 ], "density": 0.1 } ]
    }
  },
  {
    "type": "mapgen",
    "method": "json",
    "om_terrain": [ "island_temple_b_1" ],
    "weight": 250,
    "object": {
      "fill_ter": "t_rock",
      "rows": [
        "                    ####",
        "                   ##...",
        "                   #b.rr",
        "        #####      ##.r.",
        "      ###BdB###    ##.r.",
        "      #Bd...dB#    #b.rr",
        "    ###.......###  ##...",
        "    #B..Dc.CC..B#   ###M",
        "   ##d..Dc.CC..d##    #.",
        "   #B...Dc.CC...B#    #.",
        "   #d...Dc.CC...d######X",
        "   #B...Dc.CC...B#......",
        "   ##d..Dc.CC...##.````=",
        "    #B..Dc.CC...+..````=",
        "    ###.......###.```...",
        "      #Bd.....#...```.##",
        "      ###BdB#+#.````..+.",
        "        #####...````.##.",
        "          #...````...#b.",
        "          #.``````.###..",
        "          #.````...#....",
        "          #.``...###.##+",
        "          #.``.#+#b..#..",
        "          #.==.#.....+.<"
      ],
      "mapping": {
        "B": { "furniture": "f_bed", "items": [ { "item": "bed", "chance": 60 } ] },
        "d": { "furniture": "f_dresser", "items": { "item": "dresser", "chance": 40 } }
      },
      "terrain": {
        "#": "t_rock",
        "+": "t_door_c",
        ".": "t_rock_floor",
        "<": "t_stairs_up",
        "=": "t_bridge",
        "B": "t_rock_floor",
        "C": "t_rock_floor",
        "D": "t_rock_floor",
        "M": "t_rdoor_boarded",
        "X": "t_door_locked_interior",
        "`": "t_water_sh",
        "b": "t_rock_floor",
        "c": "t_rock_floor",
        "d": "t_rock_floor",
        "r": "t_carpet_red"
      },
      "furniture": { "B": "f_bed", "C": "f_bookcase", "D": "f_desk", "c": "f_chair", "d": "f_dresser", "b": "f_brazier" },
      "place_loot": [
        { "item": "note_sanguine", "x": [ 22, 23 ], "y": [ 22, 23 ], "chance": 100 },
        { "group": "cult_sacrifice", "x": 22, "y": 18, "chance": 100 },
        { "group": "cult_sacrifice", "x": 18, "y": 22, "chance": 100 },
        { "group": "cult_sacrifice", "x": 20, "y": 2, "chance": 100 },
        { "group": "cult_sacrifice", "x": 20, "y": 5, "chance": 100 },
        { "group": "sanguine_ritual", "x": 23, "y": 3, "chance": 100 },
        { "item": "arcanemap", "x": 8, "y": [ 6, 12 ], "chance": 75 },
        { "group": "sanguine_cult_books", "x": [ 11, 12 ], "y": [ 7, 13 ], "chance": 60, "repeat": 12 },
        { "group": "sanguine_cult_spells", "x": [ 11, 12 ], "y": [ 7, 13 ], "chance": 5 }
      ],
      "place_monsters": [ { "monster": "GROUP_IMPACT", "x": [ 11, 23 ], "y": [ 11, 23 ], "density": 0.15 } ],
      "place_monster": [ { "monster": "mon_dracolich", "x": 23, "y": 4 } ]
    }
  },
  {
    "type": "mapgen",
    "method": "json",
    "om_terrain": [ "island_temple_b_2" ],
    "weight": 250,
    "object": {
      "fill_ter": "t_rock",
      "rows": [
        "####                    ",
        "...##                   ",
        "rr.b#                   ",
        ".r.##      #####        ",
        ".r.##    ###.b.###      ",
        "rr.b#    #t.....t#      ",
        "...##  ###.......###    ",
        "M###   #t.........t#    ",
        ".#    ##...P===P...##   ",
        ".#    #....=```=....#   ",
        "X######b...=`~`=...b#   ",
        "......#....=```=....#   ",
        "=````.##...P===P...##   ",
        "=````..+..........t#    ",
        "...```.###.......###    ",
        "##.```...#......t#      ",
        ".+..````.#+#.b.###      ",
        ".##.````...#####        ",
        ".b#...````...#          ",
        "..###.``````.#          ",
        "....#...````.#          ",
        "+##.###...``.#          ",
        "..#..b#+#.``.#          ",
        "<.+.....#.==.#          "
      ],
      "set": [ { "point": "trap", "id": "tr_portal", "x": 0, "y": 3 } ],
      "mapping": {
        "t": {
          "furniture": "f_table",
          "items": [ { "item": "sanguine_cult_gear", "chance": 50 }, { "item": "sanguine_cult_consumables", "chance": 25 } ]
        }
      },
      "terrain": {
        "#": "t_rock",
        "+": "t_door_c",
        ".": "t_rock_floor",
        "<": "t_stairs_up",
        "=": "t_bridge",
        "M": "t_rdoor_boarded",
        "P": "t_column",
        "X": "t_door_locked_interior",
        "`": "t_water_sh",
        "b": "t_rock_floor",
        "r": "t_carpet_red",
        "t": "t_rock_floor",
        "~": "t_water_dp"
      },
      "furniture": { "t": "f_table", "b": "f_brazier" },
      "place_loot": [
        { "group": "cult_sacrifice", "x": 13, "y": 4, "chance": 25 },
        { "group": "cult_sacrifice", "x": 7, "y": 10, "chance": 25 },
        { "group": "cult_sacrifice", "x": 19, "y": 10, "chance": 25 },
        { "group": "cult_sacrifice", "x": 13, "y": 16, "chance": 25 },
        { "group": "cult_sacrifice", "x": 1, "y": 18, "chance": 25 },
        { "group": "cult_sacrifice", "x": 5, "y": 22, "chance": 25 },
        { "group": "cult_sacrifice", "x": 3, "y": 2, "chance": 100 },
        { "group": "cult_sacrifice", "x": 3, "y": 5, "chance": 100 }
      ],
      "place_monsters": [ { "monster": "GROUP_IMPACT", "x": [ 0, 12 ], "y": [ 11, 23 ], "density": 0.15 } ]
    }
  },
  {
    "type": "mapgen",
    "method": "json",
    "om_terrain": [ "island_temple_b_3" ],
    "weight": 250,
    "object": {
      "fill_ter": "t_rock",
      "rows": [
        "          #.==.#.....+.<",
        "          #.``.#+#b..#..",
        "          #.``...###.##+",
        "          #.````...#....",
        "          #.``````.###..",
        "          #...````...#b.",
        "        #####...````.##.",
        "      ###.b.#+#.````..+.",
        "      #t......#...```.##",
        "    ###.......###.```...",
        "    #t..........+..````=",
        "   ##...P===P...##.````=",
        "   #....=```=....#......",
        "   #b...=`~`=...b#######",
        "   #....=```=....#      ",
        "   ##...P===P...##      ",
        "    #t.........t#       ",
        "    ###.......###       ",
        "      #t.....t#         ",
        "      ###.b.###         ",
        "        #####           ",
        "                        ",
        "                        ",
        "                        "
      ],
      "mapping": {
        "t": {
          "furniture": "f_table",
          "items": [ { "item": "sanguine_cult_gear", "chance": 50 }, { "item": "sanguine_cult_consumables", "chance": 25 } ]
        }
      },
      "terrain": {
        "#": "t_rock",
        "+": "t_door_c",
        ".": "t_rock_floor",
        "<": "t_stairs_up",
        "=": "t_bridge",
        "P": "t_column",
        "X": "t_door_locked",
        "`": "t_water_sh",
        "b": "t_rock_floor",
        "t": "t_rock_floor",
        "~": "t_water_dp"
      },
      "furniture": { "t": "f_table", "b": "f_brazier" },
      "place_loot": [
        { "group": "cult_sacrifice", "x": 10, "y": 7, "chance": 25 },
        { "group": "cult_sacrifice", "x": 4, "y": 13, "chance": 25 },
        { "group": "cult_sacrifice", "x": 16, "y": 13, "chance": 25 },
        { "group": "cult_sacrifice", "x": 10, "y": 19, "chance": 25 },
        { "group": "cult_sacrifice", "x": 18, "y": 1, "chance": 25 },
        { "group": "cult_sacrifice", "x": 22, "y": 5, "chance": 25 }
      ],
      "place_monsters": [ { "monster": "GROUP_IMPACT", "x": [ 11, 23 ], "y": [ 0, 12 ], "density": 0.15 } ]
    }
  },
  {
    "type": "mapgen",
    "method": "json",
    "om_terrain": [ "island_temple_b_4" ],
    "weight": 250,
    "object": {
      "fill_ter": "t_rock",
      "rows": [
        "<.+.....#.==.#          ",
        "..#..b#+#.``.#          ",
        "+##.###...``.#          ",
        "....#...````.#          ",
        "..###.``````.#          ",
        ".b#...````...#          ",
        ".##.````...#####        ",
        ".+..````.#+#BdB###      ",
        "##.```...#.....dB#      ",
        "...```.###.......###    ",
        "=````..+...CC.cD..B#    ",
        "=````.##...CC.cD..d##   ",
        "......#B...CC.cD...B#   ",
        "#######d...CC.cD...d#   ",
        "      #B...CC.cD...B#   ",
        "      ##d..CC.cD..d##   ",
        "       #B..CC.cD..B#    ",
        "       ###.......###    ",
        "         #Bd...dB#      ",
        "         ###BdB###      ",
        "           #####        ",
        "                        ",
        "                        ",
        "                        "
      ],
      "mapping": {
        "B": { "furniture": "f_bed", "items": [ { "item": "bed", "chance": 60 } ] },
        "d": { "furniture": "f_dresser", "items": { "item": "dresser", "chance": 40 } }
      },
      "terrain": {
        "#": "t_rock",
        "+": "t_door_c",
        ".": "t_rock_floor",
        "<": "t_stairs_up",
        "=": "t_bridge",
        "B": "t_rock_floor",
        "C": "t_rock_floor",
        "D": "t_rock_floor",
        "X": "t_door_locked",
        "`": "t_water_sh",
        "b": "t_rock_floor",
        "c": "t_rock_floor",
        "d": "t_rock_floor"
      },
      "furniture": { "B": "f_bed", "C": "f_bookcase", "D": "f_desk", "c": "f_chair", "d": "f_dresser", "b": "f_brazier" },
      "place_loot": [
        { "group": "cult_sacrifice", "x": 5, "y": 1, "chance": 25 },
        { "group": "cult_sacrifice", "x": 1, "y": 5, "chance": 25 },
        { "group": "sanguine_cult_books", "x": [ 11, 12 ], "y": [ 10, 16 ], "chance": 60, "repeat": 12 },
        { "item": "note_sanguine_tenet", "x": [ 11, 12 ], "y": [ 10, 16 ], "chance": 90 },
        { "group": "sanguine_cult_spells", "x": [ 11, 12 ], "y": [ 10, 16 ], "chance": 5 }
      ],
      "place_monsters": [ { "monster": "GROUP_IMPACT", "x": [ 0, 12 ], "y": [ 0, 12 ], "density": 0.15 } ]
    }
  }
]
