[
  {
    "id": "unaligned_arcanist_books",
    "type": "item_group",
    "items": [
      [ "novel_drama", 5 ],
      [ "novel_experimental", 5 ],
      [ "philosophy_book", 10 ],
      [ "poetry_book", 10 ],
      [ "book_potioncraft", 20 ],
      [ "book_scrollcraft", 15 ],
      [ "book_summoning", 5 ]
    ]
  },
  {
    "id": "unaligned_arcanist_spells",
    "type": "item_group",
    "items": [
      [ "scroll_spell_confusion", 1 ],
      [ "scroll_spell_plants", 1 ],
      [ "scroll_spell_might", 1 ],
      [ "scroll_spell_clarity", 1 ],
      [ "scroll_spell_heal", 1 ],
      [ "scroll_spell_flame_armor", 1 ],
      [ "scroll_spell_invis", 1 ],
      [ "scroll_spell_free_action", 1 ],
      [ "scroll_spell_acidspray", 1 ]
    ]
  },
  {
    "id": "summoner_drops",
    "type": "item_group",
    "items": [
      [ "silver_glyph", 10 ],
      [ "silver_small", 10 ],
      [ "book_summoning", 5 ],
      [ "essence", 10 ],
      [ "summon_kreck", 3 ],
      [ "summon_blank", 2 ],
      [ "summon_flaming_eye", 1 ]
    ]
  },
  {
    "id": "summoner_casualties",
    "type": "item_group",
    "subtype": "collection",
    "entries": [
      { "group": "underwear", "damage": [ 1, 4 ] },
      { "group": "shirts", "damage": [ 1, 4 ] },
      { "group": "pants", "damage": [ 1, 4 ] },
      { "group": "shoes", "damage": [ 1, 4 ] },
      { "group": "summoner_drops", "prob": 25 },
      { "group": "magic_consumables", "prob": 10 },
      { "item": "corpse" }
    ]
  },
  {
    "type": "mapgen",
    "method": "json",
    "om_terrain": [ "strange_grove" ],
    "weight": 300,
    "object": {
      "fill_ter": "t_floor",
      "rows": [
        "                        ",
        "   TTTTTTTTTTTTTTTTTT   ",
        "  TT                TT  ",
        " TT                  TT ",
        " T                    T ",
        " T                    T ",
        " T      T  TT  T      T ",
        " T     TT      TT     T ",
        " T    TT  #..#  TT    T ",
        " T       ##..##       T ",
        " T    T ###..### T    T ",
        " T    T ###..### T    T ",
        " T       ##>>##       T ",
        " T    TT  ####  TT    T ",
        " T     TT      TT     T ",
        " T      T  TT  T      T ",
        " T                    T ",
        " T                    T ",
        " T                    T ",
        " T                    T ",
        " TT                  TT ",
        "  TT                TT  ",
        "   TTTTTTTT  TTTTTTTT   ",
        "                        "
      ],
      "terrain": {
        " ": [ "t_grass", "t_grass", "t_grass", "t_shrub", "t_shrub", "t_tree_young", "t_dirt" ],
        "#": "t_rock",
        ".": "t_rock_floor",
        ">": "t_slope_down",
        "T": "t_tree"
      },
      "furniture": {
        "B": "f_bed",
        "b": "f_bench",
        "c": "f_counter",
        "d": "f_dresser",
        "f": "f_fridge",
        "n": "f_cupboard",
        "o": "f_oven",
        "s": "f_sink",
        "t": "f_bathtub",
        "v": "f_woodstove"
      },
      "place_monsters": [
        { "monster": "GROUP_TRIFFID", "x": [ 0, 23 ], "y": [ 0, 23 ], "density": 0.1 },
        { "monster": "GROUP_NETHER", "x": [ 0, 23 ], "y": [ 0, 23 ], "density": 0.5 }
      ]
    }
  },
  {
    "type": "mapgen",
    "method": "json",
    "om_terrain": [ "grove_ruins" ],
    "weight": 300,
    "object": {
      "fill_ter": "t_dirtfloor",
      "rows": [
        "########################",
        "#WWWWR    R R  WBRR   W#",
        "#R=RWZ  R      WB   R  #",
        "#=~=WZ RR  R   WB  RR  #",
        "#~~~W~RR   RW  WBRRR   #",
        "# ~ WRR  O  W  WWWR    #",
        "#   W       WR  RR   WW#",
        "#  WW  WWWWWW  WRR RR ~#",
        "#  W    W      W~RRR RW#",
        "#WXW   RW WWWWWWR~RR  W#",
        "#      RW              #",
        "#WW   WW  WWWW WWWWW   #",
        "# RR~RR  WR<<RRR~~=RW  #",
        "#r RRR  rW      ~~==W  #",
        "#r      rW       ~~~W  #",
        "#r  O  RRWR       ~RW  #",
        "#R    RR~WR       RRW  #",
        "# WWWWR~R RR        +  #",
        "#  R  RR   WWWWWWWWWW  #",
        "#R     RR              #",
        "#RR W     RR      RR~~R#",
        "#   W O  R~RRR   RR~R=R#",
        "#W WW     R ~RR ~R~R~RR#",
        "########################"
      ],
      "set": [
        { "point": "trap", "id": "tr_portal", "x": 9, "y": 5 },
        { "point": "trap", "id": "tr_portal", "x": 4, "y": 15 },
        { "point": "trap", "id": "tr_portal", "x": 6, "y": 21 }
      ],
      "mapping": { "Z": { "furniture": "f_bed", "items": { "item": "bed", "chance": 60 } } },
      "terrain": {
        " ": "t_rock_floor",
        "#": "t_rock",
        "+": "t_door_c",
        "<": "t_slope_up",
        "=": "t_water_dp",
        "B": "t_rock_floor",
        "O": "t_rock_floor",
        "R": "t_root_wall",
        "W": "t_wall",
        "X": "t_door_boarded",
        "Z": "t_rock_floor",
        "r": "t_rock_floor",
        "~": "t_water_sh"
      },
      "furniture": { "B": "f_bookcase", "Z": "f_bed", "r": "f_rack" },
      "place_loot": [
        { "group": "summoner_casualties", "x": [ 1, 22 ], "y": [ 1, 22 ], "chance": 100, "repeat": [ 2, 6 ] },
        { "item": "book_syncretism", "x": 18, "y": 1, "chance": 40 },
        { "item": "note_grove", "x": [ 11, 15 ], "y": [ 13, 15 ], "chance": 100 },
        { "item": "arcanemap", "x": 16, "y": [ 3, 4 ], "chance": 100 },
        { "group": "unaligned_arcanist_books", "x": 16, "y": [ 1, 4 ], "chance": 50, "repeat": [ 2, 8 ] },
        { "group": "unaligned_arcanist_spells", "x": 16, "y": [ 1, 4 ], "chance": 5, "repeat": [ 2, 5 ] },
        { "group": "magic_crafting", "x": 1, "y": [ 13, 15 ], "chance": 40, "repeat": [ 3, 6 ] },
        { "group": "magic_consumables", "x": 8, "y": [ 13, 14 ], "chance": 50, "repeat": [ 2, 5 ] }
      ],
      "place_monsters": [ { "monster": "GROUP_GROVEBASEMENT", "x": [ 2, 22 ], "y": [ 2, 22 ], "density": 0.2 } ],
      "place_monster": [ { "monster": "mon_moruboru", "x": 2, "y": 8 } ]
    }
  }
]
