[
  {
    "type": "mapgen",
    "method": "json",
    "om_terrain": [ "cabin_strange_b" ],
    "weight": 450,
    "object": {
      "rows": [
        "########################",
        "##.hh..#c..cc###########",
        "##hee..#c....#...#######",
        "##hee..+.....G.b8#######",
        "##.hh..#.....#...#######",
        "##.....#....c###########",
        "###...####x###|---|---|#",
        "####x#####.###|c.h|<..|#",
        "##.rrr.##...##|..d|-x-|#",
        "#.rrrrr.#.I.##|-+-|..h##",
        "#.pprpp.#...##c......c##",
        "#.rrrrr.#.I.##ccI..Icc##",
        "#.pprpp.#...##cc.....{##",
        "#.rrrrr.#.I.##ccI..I.{##",
        "#.pprpp.#...##ee..ch.{##",
        "#.rrrrr.#.I.##eeIccI..##",
        "#..rrr..#............h##",
        "#.b.a.b.#.I..I..I..I.c##",
        "##.....##.dh.cc...BBcc##",
        "###+#+##################",
        "##....]#################",
        "##dd..]#################",
        "##dh..]#################",
        "########################"
      ],
      "palettes": [ "arcana_palette" ],
      "terrain": { "p": "t_carpet_red", "G": "t_door_bar_locked" },
      "mapping": {
        ".": { "items": { "item": "subway", "chance": 5 } },
        "a": { "furniture": "f_slab", "item": { "item": "etched_skull" } },
        "c": {
          "items": [ { "item": "dresser", "chance": 15 }, { "item": "creepy", "chance": 5 } ],
          "b": { "furniture": "f_brazier", "items": { "item": "cult_sacrifice", "chance": 100 } }
        },
        "]": { "furniture": "f_bookcase", "items": { "item": "mansion_bookcase", "chance": 100 } },
        "{": { "furniture": "f_rack", "items": { "item": "cannedfood", "chance": 50 } }
      },
      "place_loot": [ { "item": "book_magicfordummies", "x": 17, "y": 8 }, { "item": "note_starry_missive", "x": [ 2, 3 ], "y": 21 } ],
      "place_monster": [
        { "monster": "mon_dementia", "x": 4, "y": 12, "repeat": [ 3, 6 ] },
        { "monster": "mon_dementia", "x": 10, "y": 3, "repeat": [ 1, 4 ] },
        { "monster": "mon_dementia", "x": 12, "y": 7 },
        { "monster": "mon_homunculus", "x": 16, "y": 4 },
        { "monster": "mon_flesh_angel", "x": 3, "y": 22 }
      ]
    }
  },
  {
    "type": "mapgen",
    "method": "json",
    "om_terrain": [ "necropolis_b_54" ],
    "weight": 375,
    "object": {
      "fill_ter": "t_floor",
      "rows": [
        "########################",
        "########################",
        "########################",
        "#|--------|#############",
        "#|???cc..]|#.###########",
        "#|...Ic..]x...##########",
        "#|.......]|#..B#########",
        "#|D....!!!|#..D#########",
        "#|D......<|#...C########",
        "#|--------|#...C########",
        "#|hee....<|#...C########",
        "#|hee..!!!|#..d#########",
        "#|.......]|#..h#########",
        "#|...I...]x...##########",
        "#|fccchh.]|#.###########",
        "#|--------|#############",
        "########################",
        "########################",
        "########################",
        "########################",
        "########################",
        "########################",
        "########################",
        "########################"
      ],
      "palettes": [ "arcana_palette" ],
      "terrain": {
        "?": "t_rock_floor",
        "!": "t_railing_h"
      },
      "furniture": {
        "?": "f_sofa"
      },
      "mapping": {
        ".": { "item": { "item": "rock", "chance": 5 } },
        "]": { "furniture": "f_bookcase", "items": { "item": "mansion_bookcase", "chance": 100 } },
        "d": {
          "item": [ { "item": "book_magicfordummies" }, { "item": "note_soa_mission" } ]
        },
        "C": {
          "items": [ { "item": "tools_survival", "chance": 50 } ]
        }
      },
      "place_items": [
        { "item": "alcohol", "x": [ 2, 2 ], "y": [ 14, 14 ], "chance": 90 },
        { "item": "cannedfood", "x": 15, "y": [ 8, 10 ], "chance": 60, "repeat": 8 }
      ],
      "place_monsters": [ { "monster": "GROUP_NECROPOLIS_SEWERS", "x": [ 1, 22 ], "y": [ 1, 22 ], "density": 0.1 } ]
    }
  },
  {
    "type": "mapgen",
    "method": "json",
    "om_terrain": [ "cathedral_b_SE" ],
    "weight": 375,
    "object": {
      "rows": [
        "__+________|############",
        "__|_s_s_s__|############",
        "__|--------|-|##########",
        "__E________+<|##########",
        "__EH__HEEH_|-|---|######",
        "______HEEH_|}___f|######",
        "______HEEH_+____f|######",
        "___________|____o|######",
        "__M__M_____C____o|######",
        "___________C____C|######",
        "__M__M_____C____s|######",
        "_______HHH_C____C|######",
        "------------|-+-||######",
        "............x___|#######",
        "............|]]]|#######",
        ".I...I......|-x-|#######",
        "........#####...########",
        "........###.......######",
        "..I..#####{........#####",
        ".....#####{.heee..v#####",
        "..I..#####{..eeeh..#####",
        "....#######...h...######",
        "############.....#######",
        "########################"
      ],
      "palettes": [ "arcana_palette" ],
      "terrain": {
        ".": "t_concrete",
        "C": "t_floor",
        "E": "t_floor",
        "H": "t_floor",
        "M": "t_floor",
        "e": "t_concrete",
        "f": "t_floor",
        "h": "t_concrete",
        "o": "t_floor",
        "s": "t_floor",
        "v": "t_concrete",
        "}": "t_floor",
        "{": "t_concrete",
        "]": "t_floor"
      },
      "furniture": {
        "E": "f_table",
        "H": "f_chair",
        "M": "f_makeshift_bed",
        "}": "f_rack",
        "]": "f_bookcase"
      },
      "items": {
        "}": { "item": "cleaning", "chance": 70 },
        "o": { "item": "oven", "chance": 70 },
        "]": { "item": "mansion_bookcase", "chance": 100 },
        "f": { "item": "fridge", "chance": 70 }
      },
      "place_loot": [
        { "group": "cleansing_flame_books", "x": [ 13, 15 ], "y": [ 19, 20 ], "chance": 60, "repeat": 5 },
        { "item": "note_flame_tenet", "x": [ 13, 15 ], "y": [ 19, 20 ] },
        { "item": "arcanemap", "x": [ 13, 15 ], "y": [ 19, 20 ], "chance": 25 },
        { "group": "cleansing_flame_gear_consumables", "x": 10, "y": [ 18, 20 ], "chance": 30, "repeat": 4 }
      ],
      "place_monster": [
        { "monster": "mon_flesh_angel", "x": 2, "y": 19 }
      ]
    }
  }
]
