[
  {
    "id": "reading_lights",
    "type": "item_group",
    "items": [
      [ "candle", 20 ],
      [ "oil_lamp", 20 ],
      [ "flashlight", 15 ],
      [ "wearable_light", 15 ],
      [ "electric_lantern", 10 ],
      [ "gasoline_lantern", 10 ],
      [ "survivor_light", 5 ],
      [ "atomic_lamp", 1 ]
    ]
  },
  {
    "id": "magic_crafting",
    "type": "item_group",
    "items": [
      [ "gold_small", 1 ],
      [ "gold_small", 10 ],
      [ "silver_small", 2 ],
      [ "silver_small", 20 ],
      [ "scrap", 15 ],
      [ "feather", 5 ],
      [ "copper", 15 ],
      [ "diamond", 1 ],
      { "item": "essence", "prob": 25, "charges-min": 1, "charges-max": 3 },
      { "item": "essence_blood", "prob": 25, "charges-min": 2, "charges-max": 6 },
      { "item": "essence_dull", "prob": 25, "charges-min": 4, "charges-max": 8 }
    ]
  },
  {
    "type": "mapgen",
    "method": "json",
    "om_terrain": [ "basement" ],
    "weight": 75,
    "object": {
      "fill_ter": "t_rock",
      "rotation": [ 0, 3 ],
      "rows": [
        "                        ",
        "                        ",
        "                        ",
        "                        ",
        "                        ",
        "  --------------------  ",
        "  |].................|  ",
        "  |].................|  ",
        "  |].................|  ",
        "  |].........|---+---|  ",
        "  |].........|{......|  ",
        "  |--++--|-+-|{.....#|  ",
        "  |......|...|{....h#|  ",
        "  |.b..b.|.<.|{...###|  ",
        "  |......|------------  ",
        "  |..##..|              ",
        "  |......|              ",
        "  --------              ",
        "                        ",
        "                        ",
        "                        ",
        "                        ",
        "                        ",
        "                        "
      ],
      "set": [
        { "point": "trap", "id": "tr_brazier", "x": 4, "y": 13 },
        { "point": "trap", "id": "tr_brazier", "x": 7, "y": 13 }
      ],
      "terrain": {
        "#": "t_rock_floor",
        "+": "t_door_c",
        "-": "t_wall",
        ".": "t_rock_floor",
        "<": "t_stairs_up",
        "]": "t_rock_floor",
        "b": "t_rock_floor",
        "h": "t_rock_floor",
        "{": "t_rock_floor",
        "|": "t_wall"
      },
      "furniture": {
        "#": "f_counter",
        "]": "f_bookcase",
        "h": "f_chair",
        "{": "f_rack"
      },
      "place_loot": [
        { "group": "cult_sacrifice", "x": 4, "y": 13, "chance": 100 },
        { "group": "cult_sacrifice", "x": 7, "y": 13, "chance": 100 },
        { "group": "sanguine_cult_casualties", "x": 19, "y": 12, "chance": 75 },
        { "group": "sanguine_cult_books", "x": 3, "y": [ 6, 10 ], "chance": 30, "repeat": [ 2, 5 ] },
        { "item": "human_flesh", "x": 20, "y": [ 11, 13 ], "chance": 50, "repeat": [ 1, 5 ] },
        { "item": "blood_athame", "x": [ 18, 19 ], "y": 13, "chance": 75, "repeat": 1 },
        { "group": "sanguine_cult_gear", "x": 14, "y": 10, "chance": 30, "repeat": [ 2, 5 ] },
        { "item": "essence_blood", "x": [ 5, 6 ], "y": 15, "chance": 50, "repeat": [ 5, 10 ] }
      ],
      "place_monster": [
        { "monster": "mon_dementia", "x": 9, "y": 7, "repeat": [ 1, 4 ] },
        { "monster": "mon_dementia", "x": 17, "y": 11, "repeat": [ 1, 2 ] },
        { "monster": "mon_homunculus", "x": 5, "y": 16, "repeat": 1 }
      ]
    }
  },
  {
    "type": "mapgen",
    "method": "json",
    "om_terrain": [ "basement" ],
    "weight": 100,
    "object": {
      "fill_ter": "t_rock",
      "rotation": [ 0, 3 ],
      "rows": [
        " ---------------------  ",
        " |]......rrrrr......]|  ",
        " |]....b.rr#rr.b....]|  ",
        " |]......rrrrr......]|  ",
        " |].......rrr.......]|  ",
        " |].ppppp.rrr.ppppp.]|  ",
        " |........rrr........|  ",
        " |..ppppp.rrr.ppppp..|  ",
        " |........rrr........|  ",
        " |..ppppp.rrr.ppppp..|  ",
        " |...................|  ",
        " |{{{{{..|-+-|..{{{{{|  ",
        " --------|...|--------  ",
        "         |.<.|          ",
        "         -----          ",
        "                        ",
        "                        ",
        "                        ",
        "                        ",
        "                        ",
        "                        ",
        "                        ",
        "                        ",
        "                        "
      ],
      "set": [
        { "point": "trap", "id": "tr_brazier", "x": 7, "y": 2 },
        { "point": "trap", "id": "tr_brazier", "x": 15, "y": 2 }
      ],
      "terrain": {
        "#": "t_rock_floor",
        "+": "t_door_c",
        "-": "t_wall",
        ".": "t_rock_floor",
        "<": "t_stairs_up",
        "]": "t_rock_floor",
        "b": "t_rock_floor",
        "h": "t_rock_floor",
        "p": "t_rock_floor",
        "r": "t_carpet_red",
        "{": "t_rock_floor",
        "|": "t_wall"
      },
      "furniture": {
        "#": "f_counter",
        "B": "f_bed",
        "D": "f_dresser",
        "]": "f_bookcase",
        "p": "f_bench",
        "{": "f_rack"
      },
      "place_loot": [
        { "item": "holy_symbol", "x": 11, "y": 2, "chance": 90 },
        { "group": "cleansing_flame_casualties", "x": [ 2, 20 ], "y": [ 1, 10 ], "chance": 75, "repeat": [ 2, 4 ] },
        { "group": "cleansing_flame_books", "x": 2, "y": [ 1, 5 ], "chance": 40, "repeat": [ 2, 5 ] },
        { "group": "cleansing_flame_books", "x": 20, "y": [ 1, 5 ], "chance": 40, "repeat": [ 2, 5 ] },
        { "group": "cleansing_flame_gear", "x": [ 2, 6 ], "y": 11, "chance": 30, "repeat": [ 2, 5 ] },
        { "group": "cleansing_flame_gear_magic", "x": [ 2, 6 ], "y": 11, "chance": 25, "repeat": [ 2, 5 ] },
        { "group": "cleansing_flame_crafting", "x": [ 16, 20 ], "y": 11, "chance": 40, "repeat": [ 2, 5 ] }
      ],
      "place_monsters": [
        { "monster": "GROUP_PREPPER_HOUSE", "x": [ 2, 20 ], "y": [ 1, 10 ] }
      ]
    }
  },
  {
    "type": "mapgen",
    "method": "json",
    "om_terrain": [ "basement" ],
    "weight": 50,
    "object": {
      "fill_ter": "t_rock",
      "rotation": [ 0, 3 ],
      "rows": [
        "                        ",
        "                        ",
        "                        ",
        "                        ",
        "      -----------       ",
        "      |.........|       ",
        "      |.........|       ",
        "      |+-|-+-|-+|       ",
        "      |rr|...|rr|       ",
        "      |rr|.<.|rr|       ",
        "      |rr|...|rr|       ",
        "     -|rr|-+-|rr|-      ",
        "     |rr--...--rr|      ",
        "     |rr-]...]-rr|      ",
        "     |rr--]{]--rr|      ",
        "     -|rr-----rr|-      ",
        "    |---+-]]]-+---|     ",
        "    |.............|     ",
        "    |.p.p..b..p.p.|     ",
        "    |.p.p.....p.p.|     ",
        "    |......P......|     ",
        "    ---------------     ",
        "                        ",
        "                        "
      ],
      "set": [
        { "point": "trap", "id": "tr_brazier", "x": 11, "y": 18 },
        { "point": "trap", "id": "tr_portal", "x": 11, "y": 20 }
      ],
      "terrain": {
        "#": "t_rock_floor",
        "+": "t_door_c",
        "-": "t_wall",
        ".": "t_rock_floor",
        "<": "t_stairs_up",
        "P": "t_rock_floor",
        "]": "t_rock_floor",
        "b": "t_rock_floor",
        "h": "t_rock_floor",
        "p": "t_rock_floor",
        "r": "t_carpet_red",
        "{": "t_rock_floor",
        "|": "t_wall"
      },
      "furniture": {
        "#": "f_counter",
        "]": "f_bookcase",
        "p": "f_bench",
        "{": "f_rack"
      },
      "place_loot": [
        { "item": "offering_chalice_used", "x": 11, "y": 19, "chance": 100 },
        { "group": "chalice_cult_casualties", "x": 11, "y": 13, "chance": 100 },
        { "group": "chalice_cult_casualties", "x": [ 2, 20 ], "y": [ 1, 10 ], "chance": 75, "repeat": [ 1, 3 ] },
        { "group": "chalice_cult_books", "x": [ 10, 12 ], "y": 16, "chance": 40, "repeat": [ 2, 5 ] },
        { "group": "chalice_cult_books", "x": 9, "y": 13, "chance": 25, "repeat": [ 1, 3 ] },
        { "group": "chalice_cult_books", "x": 13, "y": 13, "chance": 25, "repeat": [ 1, 3 ] },
        { "group": "chalice_cult_books", "x": 10, "y": 14, "chance": 25, "repeat": [ 1, 3 ] },
        { "group": "chalice_cult_books", "x": 12, "y": 14, "chance": 25, "repeat": [ 1, 3 ] },
        { "group": "chalice_cult_gear", "x": 11, "y": 14, "chance": 30, "repeat": [ 1, 4 ] },
        { "group": "cult_sacrifice", "x": 11, "y": 18, "chance": 100 }
      ],
      "place_monsters": [
        { "monster": "GROUP_NETHER", "x": [ 5, 17 ], "y": [ 17, 20 ] },
        { "monster": "GROUP_NETHER", "x": [ 7, 15 ], "y": [ 5, 6 ], "chance": 2 }
      ],
      "place_monster": [
        { "monster": "mon_dementia", "x": 11, "y": 13, "repeat": [ 1, 2 ] },
        { "monster": "mon_flesh_angel", "x": 11, "y": 19 }
      ]
    }
  },
  {
    "type": "mapgen",
    "method": "json",
    "om_terrain": [ "basement" ],
    "weight": 125,
    "object": {
      "fill_ter": "t_rock",
      "rotation": [ 0, 3 ],
      "rows": [
        "  --------------------  ",
        "  |B.........#####..]|  ",
        "  |D................]|  ",
        "  |.................]|  ",
        "  |.................]|  ",
        "  |.................]|  ",
        "  |{.................|  ",
        "  |{................#|  ",
        "  |{...............hd|  ",
        "  |{.................|  ",
        "  |{................s|  ",
        "  |------|-+-|-------|  ",
        "         |...|          ",
        "         |.<.|          ",
        "         -----          ",
        "                        ",
        "                        ",
        "                        ",
        "                        ",
        "                        ",
        "                        ",
        "                        ",
        "                        ",
        "                        "
      ],
      "terrain": {
        "#": "t_rock_floor",
        "+": "t_door_c",
        "-": "t_wall",
        ".": "t_rock_floor",
        "<": "t_stairs_up",
        "B": "t_rock_floor",
        "D": "t_rock_floor",
        "]": "t_rock_floor",
        "d": "t_rock_floor",
        "h": "t_rock_floor",
        "s": "t_rock_floor",
        "{": "t_rock_floor",
        "|": "t_wall"
      },
      "furniture": {
        "#": "f_counter",
        "B": "f_bed",
        "D": "f_dresser",
        "]": "f_bookcase",
        "d": "f_desk",
        "h": "f_chair",
        "p": "f_bench",
        "s": "f_safe_l",
        "{": "f_rack"
      },
      "place_loot": [
        { "group": "bed", "x": 3, "y": 1, "chance": 90, "repeat": [ 1, 2 ] },
        { "group": "dresser", "x": 3, "y": 2, "chance": 85, "repeat": [ 1, 4 ] },
        { "item": "matches", "x": 20, "y": 7, "chance": 50 },
        { "group": "reading_lights", "x": 20, "y": 7, "chance": 90 },
        { "group": "cannedfood", "x": [ 13, 17 ], "y": 1, "chance": 75, "repeat": [ 2, 5 ] },
        { "group": "homebooks", "x": 20, "y": [ 1, 5 ], "chance": 75, "repeat": [ 3, 6 ] },
        { "group": "magic_books", "x": 20, "y": [ 1, 5 ], "chance": 50, "repeat": [ 2, 4 ] },
        { "group": "magic_crafting", "x": 3, "y": [ 6, 10 ], "chance": 35, "repeat": [ 5, 8 ] },
        { "group": "magic_consumables", "x": 20, "y": 10, "chance": 50, "repeat": [ 1, 3 ] },
        { "group": "magic_items", "x": 20, "y": 10, "chance": 50, "repeat": [ 1, 2 ] },
        { "group": "magic_tools", "x": 20, "y": 10, "chance": 50 }
      ],
      "place_monsters": [
        { "monster": "GROUP_NETHER", "x": [ 3, 20 ], "y": [ 1, 10 ], "chance": 25 },
        { "monster": "GROUP_IMPACT", "x": [ 3, 20 ], "y": [ 1, 10 ], "chance": 25 },
        { "monster": "GROUP_PREPPER_HOUSE", "x": [ 3, 20 ], "y": [ 1, 10 ] }
      ]
    }
  }
]
