[
  {
    "id": "sanguine_cult_books",
    "type": "item_group",
    "items": [
      [ "plays_book", 4 ],
      [ "poetry_book", 4 ],
      [ "philosophy_book", 2 ],
      [ "novel_drama", 1 ],
      [ "essay_book", 2 ],
      [ "cookbook_human", 1 ],
      [ "textbook_speech", 1 ],
      [ "book_bloodmagic", 6 ],
      [ "book_summoning", 1 ],
      [ "book_potioncraft", 2 ]
    ]
  },
  {
    "id": "sanguine_cult_spells",
    "type": "item_group",
    "items": [
      [ "scroll_spell_confusion", 1 ],
      [ "scroll_spell_agile", 1 ],
      [ "scroll_spell_elecresist", 1 ],
      [ "scroll_spell_clarity", 1 ],
      [ "scroll_spell_acidspray", 1 ]
    ]
  },
  {
    "id": "sanguine_cult_gear",
    "type": "item_group",
    "items": [
      [ "blood_athame", 5 ],
      [ "bloodaxe", 3 ],
      [ "bloodscourge", 2 ],
      [ "armor_wyrm", 3 ],
      [ "revenant_crown", 2 ],
      [ "portal", 1 ]
    ]
  },
  {
    "id": "sanguine_cult_consumables",
    "type": "item_group",
    "items": [
      { "item": "essence_blood", "prob": 10, "count": [ 1, 3 ] },
      [ "numbness_potion", 4 ],
      [ "strength_potion", 1 ],
      [ "speed_potion", 2 ],
      [ "summon_dark_wyrm", 1 ],
      [ "summon_mi_go", 1 ],
      [ "summon_flying_polyp", 1 ],
      [ "summon_yugg", 1 ]
    ]
  },
  {
    "id": "sanguine_cult_crafting",
    "type": "item_group",
    "items": [
      [ "gold_small", 10 ],
      [ "silver_small", 25 ],
      [ "bone_human", 25 ],
      [ "rag_bloody", 35 ],
      [ "scrap", 30 ],
      [ "diamond", 5 ],
      [ "brooch", 5 ]
    ]
  },
  {
    "id": "sanguine_cult_casualties",
    "type": "item_group",
    "subtype": "collection",
    "entries": [
      { "group": "underwear", "damage": [ 1, 4 ] },
      { "group": "shirts", "damage": [ 1, 4 ] },
      { "group": "pants", "damage": [ 1, 4 ] },
      { "group": "shoes", "damage": [ 1, 4 ] },
      { "group": "sanguine_cult_gear", "prob": 25 },
      { "item": "corpse" }
    ]
  },
  {
    "id": "sanguine_ritual",
    "type": "item_group",
    "subtype": "collection",
    "entries": [ { "item": "silver_glyph" }, { "item": "essence_blood" }, { "item": "cleric_ring" } ]
  },
  {
    "type": "mapgen",
    "method": "json",
    "om_terrain": [ "island_temple_1" ],
    "weight": 250,
    "object": {
      "rows": [
        ",,,,,,,,,,,,,,,,,,,~~~~,",
        ",,,,,,,,,~~~~~~~~~~~~~~g",
        ",,,,,,,~~~~~~~~~~~~~;;;g",
        ",,,,,~~~~~;;;;;;;;;;;;;g",
        ",,,,~~~;;;;;;;;;;;;;;;;g",
        ",,,~~~;;;;;;;;;;;;;;;;;g",
        ",,~~~;;;;;;;;;;;;;;;;;;g",
        ",,~~;;;;;;;;;;;;;;;;;;;g",
        ",,~~;;;;;;;;;;;;;;;;;;;g",
        ",~~~;;;;;;;;;;;;;;;;;;;g",
        ",~~;;;;;;;;;;;;;;;;;;;;g",
        ",~~;;;;;;;;;;;;;;;;;;;;g",
        ",~~;;;;;;;;;;;;;;;;~~~~g",
        ",~~;;;;;;;;;;;;;;;;~~~~,",
        ",~~;;;;;;;;;;;;;;;~~~,,,",
        ",~~;;;;;;;;;;;;;;;~~~,|-",
        ",~~;;;;;;;;;;;;;~~~~,,+.",
        ",~~;;;;;;;;;;;;;~~~~,||.",
        ",~~;;;;;;;;;;;~~~~,,,|d.",
        ",~~;;;;;;;;;~~~~~~,|-|h.",
        "~~~;;;;;;;;;~~~~,,,|....",
        "~~;;;;;;;;;;~~,,,|-|.|-+",
        "~~;;;;;;;;;;~~,|+|dh.|..",
        ",gggggggggggg,,|.....+.>"
      ],
      "palettes": [ "arcana_palette" ],
      "mapping": { "h": { "furniture": "f_chair", "items": { "item": "sanguine_cult_casualties", "chance": 30 } } },
      "place_monsters": [ { "monster": "GROUP_IMPACT", "x": [ 0, 23 ], "y": [ 0, 23 ], "density": 0.1 } ]
    }
  },
  {
    "type": "mapgen",
    "method": "json",
    "om_terrain": [ "island_temple_2" ],
    "weight": 250,
    "object": {
      "rows": [
        ",~~~~,,,,,,,,,,,,,,,,,,,",
        "g~~~~~~~~~~~~~~,,,,,,,,,",
        "g;;;~~~~~~~~~~~~~~,,,,,,",
        "g;;;;;;;;;;;;;~~~~~,,,,,",
        "g;;;;;;;;;;;;;;;;~~~,,,,",
        "g;;;;;;;;;;;;;;;;;~~~,,,",
        "g;;;;;;;;;;;;;;;;;;~~~,,",
        "g;;;;;;;;;;;;;;;;;;;~~,,",
        "g;;;;;;;;;;;;;;;;;;;~~,,",
        "g;;;;;;;;;;;;;;;;;;;~~~,",
        "g;;;;;;;;;;;;;;;;;;;;~~,",
        "g;;;;;;;;;;;;;;;;;;;;~~,",
        "g~~~~;;;;;;;;;;;;;;;;~~,",
        ",~~~~;;;;;;;;;;;;;;;;~~,",
        ",,,~~~;;;;;;;;;;;;;;;~~,",
        "-|,~~~;;;;;;;;;;;;;;;~~,",
        ".+,,~~~~;;;;;;;;;;;;;~~,",
        ".||,~~~~;;;;;;;;;;;;;~~,",
        ".d|,,,~~~~;;;;;;;;;;;~~,",
        ".h|-|,~~~~~~;;;;;;;;;~~,",
        "....|,,,~~~~;;;;;;;;;~~~",
        "+-|.|-|,,,~~;;;;;;;;;;~~",
        "..|.hd|+|,~~;;;;;;;;;;~~",
        ">.+.....|,,gggggggggggg,"
      ],
      "palettes": [ "arcana_palette" ],
      "mapping": { "h": { "furniture": "f_chair", "items": { "item": "sanguine_cult_casualties", "chance": 30 } } },
      "place_monsters": [ { "monster": "GROUP_IMPACT", "x": [ 0, 23 ], "y": [ 0, 23 ], "density": 0.1 } ]
    }
  },
  {
    "type": "mapgen",
    "method": "json",
    "om_terrain": [ "island_temple_3" ],
    "weight": 250,
    "object": {
      "fill_ter": "t_dirt",
      "rows": [
        ",gggggggggggg,,|.....+.>",
        "~~;;;;;;;;;;~~,|+|dh.|..",
        "~~;;;;;;;;;;~~,,,|-|.|-+",
        "~~;;;;;;;;;;~~~~,,,|....",
        "~~~;;;;;;;;;~~~~~~,|-|h.",
        ",~~;;;;;;;;;;;~~~~,,,|d.",
        ",~~;;;;;;;;;;;;;~~~~,||.",
        ",~~;;;;;;;;;;;;;~~~~,,+.",
        ",~~;;;;;;;;;;;;;;;~~~,|-",
        ",~~;;;;;;;;;;;;;;;~~~,,,",
        ",~~;;;;;;;;;;;;;;;;~~~~,",
        ",~~;;;;;;;;;;;;;;;;~~~~g",
        ",~~;;;;;;;;;;;;;;;;;;;;g",
        ",~~;;;;;;;;;;;;;;;;;;;;g",
        ",~~~;;;;;;;;;;;;;;;;;;;g",
        ",,~~;;;;;;;;;;;;;;;;;;;g",
        ",,~~;;;;;;;;;;;;;;;;;;;g",
        ",,~~~;;;;;;;;;;;;;;;;;;g",
        ",,,~~~;;;;;;;;;;;;;;;;;g",
        ",,,,~~~;;;;;;;;;;;;;;;;g",
        ",,,,,~~~~~;;;;;;;;;;;;;g",
        ",,,,,,~~~~~~~~~~~~~~;;;g",
        ",,,,,,,,,~~~~~~~~~~~~~~g",
        ",,,,,,,,,,,,,,,,,,,~~~~,"
      ],
      "palettes": [ "arcana_palette" ],
      "mapping": { "h": { "furniture": "f_chair", "items": { "item": "sanguine_cult_casualties", "chance": 30 } } },
      "place_monsters": [ { "monster": "GROUP_IMPACT", "x": [ 0, 23 ], "y": [ 0, 23 ], "density": 0.1 } ]
    }
  },
  {
    "type": "mapgen",
    "method": "json",
    "om_terrain": [ "island_temple_4" ],
    "weight": 250,
    "object": {
      "rows": [
        ">.+.....|,,gggggggggggg,",
        "..|.hd|+|,~~;;;;;;;;;;~~",
        "+-|.|-|,,,~~;;;;;;;;;;~~",
        "....|,,,~~~~;;;;;;;;;;~~",
        ".h|-|,~~~~~~;;;;;;;;;~~~",
        ".d|,,,~~~~;;;;;;;;;;;~~,",
        ".||,~~~~;;;;;;;;;;;;;~~,",
        ".+,,~~~~;;;;;;;;;;;;;~~,",
        "-|,~~~;;;;;;;;;;;;;;;~~,",
        ",,,~~~;;;;;;;;;;;;;;;~~,",
        ",~~~~;;;;;;;;;;;;;;;;~~,",
        "g~~~~;;;;;;;;;;;;;;;;~~,",
        "g;;;;;;;;;;;;;;;;;;;;~~,",
        "g;;;;;;;;;;;;;;;;;;;;~~,",
        "g;;;;;;;;;;;;;;;;;;;~~~,",
        "g;;;;;;;;;;;;;;;;;;;~~,,",
        "g;;;;;;;;;;;;;;;;;;;~~,,",
        "g;;;;;;;;;;;;;;;;;;~~~,,",
        "g;;;;;;;;;;;;;;;;;~~~,,,",
        "g;;;;;;;;;;;;;;;;~~~,,,,",
        "g;;;;;;;;;;;;;~~~~~,,,,,",
        "g;;;~~~~~~~~~~~~~~,,,,,,",
        "g~~~~~~~~~~~~~~,,,,,,,,,",
        ",~~~~,,,,,,,,,,,,,,,,,,,"
      ],
      "palettes": [ "arcana_palette" ],
      "mapping": { "h": { "furniture": "f_chair", "items": { "item": "sanguine_cult_casualties", "chance": 30 } } },
      "place_monsters": [ { "monster": "GROUP_IMPACT", "x": [ 0, 23 ], "y": [ 0, 23 ], "density": 0.1 } ]
    }
  },
  {
    "type": "mapgen",
    "method": "json",
    "om_terrain": [ "island_temple_b_1" ],
    "weight": 250,
    "object": {
      "fill_ter": "t_rock",
      "rows": [
        "                    ====",
        "                   ==...",
        "                   =b.rr",
        "        =====      ==.rr",
        "      ===BDB===    ==.rr",
        "      =BD...DB=    =b.rr",
        "    ===.......===  ==...",
        "    =B..dh.]]..B=   ===+",
        "   ==D..dh.]]..D==    =i",
        "   =B...dh.]]...B=    =.",
        "   =D...dh.]]...D======x",
        "   =B...dh.]]...B=......",
        "   ==D..dh.]]...==.~~~~g",
        "    =B..dh.]]...+..~~~~g",
        "    ===.......===.~~~...",
        "      =BD.....=...~~~.==",
        "      ===BDB=+=.~~~~..+.",
        "        =====...~~~~.==.",
        "          =...~~~~...=b.",
        "          =.~~~~~~.===..",
        "          =.~~~~...=....",
        "          =.~~...===.==+",
        "          =.~~.=+=b..=..",
        "          =.gg.=.....+.<"
      ],
      "palettes": [ "arcana_palette" ],
      "mapping": {
        "]": { "furniture": "f_bookcase", "items": { "item": "sanguine_cult_books", "chance": 40, "repeat": 3 } },
        "b": { "furniture": "f_brazier", "items": { "item": "cult_sacrifice" } }
      },
      "place_loot": [
        { "item": "note_sanguine", "x": [ 22, 23 ], "y": [ 22, 23 ], "chance": 100 },
        { "group": "sanguine_ritual", "x": 23, "y": 3, "chance": 100 },
        { "item": "arcanemap", "x": 8, "y": [ 6, 12 ], "chance": 75 },
        { "group": "sanguine_cult_spells", "x": [ 11, 12 ], "y": [ 7, 13 ], "chance": 5 }
      ],
      "place_monsters": [ { "monster": "GROUP_IMPACT", "x": [ 11, 23 ], "y": [ 11, 23 ], "density": 0.1 } ],
      "place_monster": [ { "monster": "mon_dracolich", "x": 23, "y": 4 } ]
    }
  },
  {
    "type": "mapgen",
    "method": "json",
    "om_terrain": [ "island_temple_b_2" ],
    "weight": 250,
    "object": {
      "fill_ter": "t_rock",
      "rows": [
        "====                    ",
        "...==                   ",
        "rr.b=                   ",
        "rr.==      =====        ",
        "rr.==    ===.b.===      ",
        "rr.b=    =a.....a=      ",
        "...==  ===.......===    ",
        "+===   =a.........a=    ",
        "i=    ==...IgggI...==   ",
        ".=    =....g~~~g...8=   ",
        "x======b...g~;~g...a=   ",
        "......=....g~~~g...[=   ",
        "g~~~~.==...IgggI...==   ",
        "g~~~~..+..........a=    ",
        "...~~~.===.......===    ",
        "==.~~~...=......a=      ",
        ".+..~~~~.=+=.b.===      ",
        ".==.~~~~...=====        ",
        ".b=...~~~~...=          ",
        "..===.~~~~~~.=          ",
        "....=...~~~~.=          ",
        "+==.===...~~.=          ",
        "..=..b=+=.~~.=          ",
        "<.+.....=.gg.=          "
      ],
      "palettes": [ "arcana_palette" ],
      "mapping": { 
        "a": { "furniture": "f_slab", "items": [ { "item": "sanguine_cult_crafting", "chance": 50 } ] },
        "b": { "furniture": "f_brazier", "items": { "item": "cult_sacrifice" } }
      },
      "place_monsters": [ { "monster": "GROUP_IMPACT", "x": [ 0, 12 ], "y": [ 11, 23 ], "density": 0.1 } ]
    }
  },
  {
    "type": "mapgen",
    "method": "json",
    "om_terrain": [ "island_temple_b_3" ],
    "weight": 250,
    "object": {
      "fill_ter": "t_rock",
      "rows": [
        "          =.gg.=.....+.<",
        "          =.~~.=+=b..=..",
        "          =.~~...===.==+",
        "          =.~~~~...=....",
        "          =.~~~~~~.===..",
        "          =...~~~~...=b.",
        "        =====...~~~~.==.",
        "      ===.b.=+=.~~~~..+.",
        "      =a......=...~~~.==",
        "    ===.......===.~~~...",
        "    =a..........+..~~~~g",
        "   ==...IgggI...==.~~~~g",
        "   =[...g~~~g....=......",
        "   =a...g~;~g...b=======",
        "   =8...g~~~g....=      ",
        "   ==...IgggI...==      ",
        "    =a.........a=       ",
        "    ===.......===       ",
        "      =a.....a=         ",
        "      ===.b.===         ",
        "        =====           ",
        "                        ",
        "                        ",
        "                        "
      ],
      "palettes": [ "arcana_palette" ],
      "mapping": { 
        "a": { "furniture": "f_slab", "items": [ { "item": "sanguine_cult_crafting", "chance": 50 } ] },
        "b": { "furniture": "f_brazier", "items": { "item": "cult_sacrifice" } }
      },
      "place_monsters": [ { "monster": "GROUP_IMPACT", "x": [ 11, 23 ], "y": [ 0, 12 ], "density": 0.1 } ]
    }
  },
  {
    "type": "mapgen",
    "method": "json",
    "om_terrain": [ "island_temple_b_4" ],
    "weight": 250,
    "object": {
      "fill_ter": "t_rock",
      "rows": [
        "<.+.....=.gg.=          ",
        "..=..b=+=.~~.=          ",
        "+==.===...~~.=          ",
        "....=...~~~~.=          ",
        "..===.~~~~~~.=          ",
        ".b=...~~~~...=          ",
        ".==.~~~~...=====        ",
        ".+..~~~~.=+=BDB===      ",
        "==.~~~...=.....DB=      ",
        "...~~~.===.......===    ",
        "g~~~~..+...]].hd..B=    ",
        "g~~~~.==...]].hd..D==   ",
        "......=B...]].hd...B=   ",
        "=======D...]].hd...D=   ",
        "      =B...]].hd...B=   ",
        "      ==D..]].hd..D==   ",
        "       =B..]].hd..B=    ",
        "       ===.......===    ",
        "         =BD...DB=      ",
        "         ===BDB===      ",
        "           =====        ",
        "                        ",
        "                        ",
        "                        "
      ],
      "palettes": [ "arcana_palette" ],
      "mapping": {
        "]": { "furniture": "f_bookcase", "items": { "item": "sanguine_cult_books", "chance": 40, "repeat": 3 } },
        "b": { "furniture": "f_brazier", "items": { "item": "cult_sacrifice" } }
      },
      "place_loot": [
        { "item": "note_sanguine_tenet", "x": [ 11, 12 ], "y": [ 10, 16 ], "chance": 90 },
        { "group": "sanguine_cult_spells", "x": [ 11, 12 ], "y": [ 10, 16 ], "chance": 5 }
      ],
      "place_monsters": [ { "monster": "GROUP_IMPACT", "x": [ 0, 12 ], "y": [ 0, 12 ], "density": 0.1 } ]
    }
  }
]
